1,0,1,1,1,0,1,1,1,0
1,0,1,0,1,0,1,0,1,0
1,0,1,0,1,0,1,0,1,0
1,0,1,0,1,0,1,0,1,0
1,0,1,0,1,0,1,0,1,0
1,0,1,0,1,0,1,0,1,0
1,0,1,0,1,0,1,0,1,0
1,0,1,0,1,0,1,0,1,0
1,0,1,0,1,0,1,0,1,0
1,1,1,0,1,1,1,0,1,1
fin
0
9